1111111111111111111
11P00000000CC00E111
1111111111111111111
